To seize|Захватить|[siːz]|B2|VERB
To nourish|Питать|[ˈnʌrɪʃ]|B2|VERB
To desist|Запретить|[dɪˈzɪst]|B2|VERB
To recapitulate|Пересказывать|[riːkəˈpɪtjʊleɪt]|B2|VERB
To proclaim|Провозгласить;Объявить|[prəˈkleɪm]|B2|VERB
To beget|Родить|[bɪˈgɛt]|B2|VERB
To mature|Созреть|[məˈtjʊə]|B2|VERB
To contemplate|Созерцать|[ˈkɒntɛmpleɪt]|B2|VERB
To flourish|Процветать|[ˈflʌrɪʃ]|B2|VERB
To cable|Проводить|[ˈkeɪbl]|B2|VERB
To congregate|Собираться|[ˈkɒŋgrɪgeɪt]|B2|VERB
To induce|Побудить;Побуждать|[ɪnˈdjuːs]|B2|VERB
To highlight|Выделять|[ˈhaɪˌlaɪt]|B2|VERB
To foretell|Предсказывать|[fɔːˈtɛl]|B2|VERB
To foreshadow|Предвещать|[fɔːˈʃædəʊ]|B2|VERB
To interlace|Переплетать|[ɪntə(ː)ˈleɪs]|B2|VERB
To relish|Наслаждаться;Смаковать|[ˈrɛlɪʃ]|B2|VERB
To tread|Ухаживать|[trɛd]|B2|VERB
To rehearse|Репетировать|[rɪˈhɜːs]|B2|VERB
To narrate|Рассказывать|[nəˈreɪt]|B2|VERB
To alleviate|Облегчать;Облегчить|[əˈliːvɪeɪt]|B2|VERB
To bilk|Обналичивать|[bɪlk]|B2|VERB
To refine|Усовершенствовать|[rɪˈfaɪn]|B2|VERB
To restructure|Реструктурировать|[riːˈstrʌkʧə]|B2|VERB
To decay|Распадаться|[dɪˈkeɪ]|B2|VERB
To corrupt|Развращать|[kəˈrʌpt]|B2|VERB
To alter|Изменяться|[ˈɔːltə]|B2|VERB
To discern|Различить|[dɪˈsɜːn]|B2|VERB
To disclose|Раскрыть|[dɪsˈkləʊz]|B2|VERB
To inscribe|Начертать|[ɪnˈskraɪb]|B2|VERB
To proffer|Предложить|[ˈprɒfə]|B2|VERB
To meddle|Вмешиваться|[ˈmɛdl]|B2|VERB
To violate|Нарушать|[ˈvaɪəleɪt]|B2|VERB
To further|Продолжать|[ˈfɜːðə]|B2|VERB
To humble|Смирять|[hʌmbl]|B2|VERB
To subdue|Покорять|[səbˈdjuː]|B2|VERB
To demote|Понижать;Разжаловать|[dɪˈməʊt]|B2|VERB
To obey|Подчиняться;Слушаться|[əˈbeɪ]|B2|VERB
To employ|Нанимать|[ɪmˈplɔɪ]|B2|VERB
To chastise|Наказывать|[ʧæsˈtaɪz]|B2|VERB
To concoct|Придумать|[kənˈkɒkt]|B2|VERB
To condone|Потворствовать|[kənˈdəʊn]|B2|VERB
To cringe|Сокрушаться|[krɪnʤ]|B2|VERB
To ensconce|Приютить;Успокоить|[ɪnˈskɒns]|B2|VERB
To sanction|Наказывать|[ˈsæŋkʃən]|B2|VERB
To affix|Прикрепить;Зафиксировать|[ˈæfɪks]|B2|VERB
To curb|Ограничить;Обуздать|[kɜːb]|B2|VERB
To restrain|Сдерживать|[rɪsˈtreɪn]|B2|VERB
To enlarge|Увеличить;Повысить|[ɪnˈlɑːʤ]|B2|VERB
To govern|Управлять|[ˈgʌvən]|B2|VERB
To reckon|Пересчитать|[ˈrɛkən]|B2|VERB
To esteem|Ценить;Уважать|[ɪsˈtiːm]|B2|VERB
To sweeten|Подсластить|[swiːtn]|B2|VERB
To fluctuate|Колебаться|[ˈflʌktjʊeɪt]|B2|VERB
To fare|Зависеть;Дорожать;Подвергаться|[feə]|B2|VERB
To halt|Остановить;Останавливать|[hɔːlt]|B2|VERB
To endure|Выдержать;Выдерживать|[ɪnˈdjʊə]|B2|VERB
To revenge|Мстить|[rɪˈvɛnʤ]|B2|VERB
To attain|Достигать;Достичь|[əˈteɪn]|B2|VERB
To divest|Расставаться|[daɪˈvɛst]|B2|VERB
To elucidate|Прояснить|[ɪˈluːsɪdeɪt]|B2|VERB
To invent|Изобретать;Придумывать|[ɪnˈvɛnt]|B2|VERB
To shield|Защищать|[ʃiːld]|B2|VERB
To resemble|Походить;Быть похожим;Напоминать|[rɪˈzɛmbl]|B2|VERB
To ingest|Проглотить;Заглотить|[ ɪnˈʤɛst]|B2|VERB
To dispense|Раздавать;Дозировать;Выдавать|[dɪsˈpɛns]|B2|VERB
To match|Соответствовать|[mæʧ]|B2|VERB
To engross|Вовлечь;Увлечь;Задействовать|[ɪnˈgrəʊs]|B2|VERB
To collude|Сговориться;Войти|[kəˈluːd]|B2|VERB
To split|Разделить;Разрушить|[splɪt]|B2|VERB
To unveil|Раскрыть;Огласить;Показать|[ʌnˈveɪl]|B2|VERB
To bear|Выносить;Выдерживать;Рожать|[beə]|B2|VERB
To prompt|Подсказать;Побудить|[prɒmpt]|B2|VERB
To mold|Лепить;Формировать|[məʊld]|B2|VERB
To rub|Натирать;Втирать;Растирать|[rʌb]|B2|VERB
To stomp|Топтать;Затоптать|[stɒmp]|B2|VERB
To narrate|Рассказывать;Повествовать|[nəˈreɪt]|B2|VERB
To sense|Чувствовать;Понимать|[sɛns]|B2|VERB
To outdate|Устаревать|[ˈaʊtˌdeɪt]|B2|VERB
To clutter|Загромождать;Захламить|[ˈklʌtə]|B2|VERB
To scrabble|Царапать|[ˈskræbl]|B2|VERB
To accuse|Обвинять|[əˈkjuːz]|B2|VERB
To summon|Вызвать;Созвать|[ˈsʌmən]|B2|VERB
To outfit|Снарядить;Обмундировать|[ˈaʊtfɪt]|B2|VERB
To convert|Преобразовать|[ˈkɒnvɜːt]|B2|VERB
To override|Переопределить;Перераспределить|[əʊvəˈraɪd]|B2|VERB
To bind|Связать|[baɪnd]|B2|VERB
To nurture|Воспитывать|[ˈnɜːʧə]|B2|VERB
To recount|Пересказывать|[riːˈkaʊnt]|B2|VERB
To backlog|Отставать|[ˈbæklɒg]|B2|VERB
To inspectorate|Инспектировать;Проверять|[ɪnˈspɛktərɪt]|B2|VERB
To unearth|Раскопать|[ʌnˈɜːθ]|B2|VERB
To demote|Понизить в должности;Разжаловать|[dɪˈməʊt]|B2|VERB
To trap|Заманить в ловушку|[træp]|B2|VERB
Questionnaire|Анкета;Опросник|[ˌkwɛstɪəˈneə]|B2|NOUN
Oversight|Надзор;Контроль;Проверка|[ˈəʊvəsaɪt]|B2|NOUN
Stewardship|Ответственность;Управление|[ˈəʊvəsaɪt]|B2|NOUN
Estimating|Оценивание;Подсчет;Оценка|[ˈɛstɪmeɪtɪŋ]|B2|NOUN
Inquiry|Исследование;Опрос;Изучение;Следствие|[ɪnˈkwaɪəri]|B2|NOUN
Contemplation|Размышление;Обдумывание;Рассуждение|[ˌkɒntɛmˈpleɪʃən]|B2|NOUN
Alternative|Альтернатива|[ɔːlˈtɜːnətɪv]|B2|NOUN
Grade|Класс;Ранг;Балл;Оценка|[greɪd]|B2|NOUN
Graduate|Выпускник;Дипломник|[ˈgrædjʊət]|B2|NOUN
Credential|Диплом;Аттестат;Свидетельство|[krɪˈdɛnʃəl]|B2|NOUN
Accolade|Награда;Похвала;Благодарность|[ækəʊleɪd]|B2|NOUN
Scale|Шкала;Величина|[skeɪl]|B2|NOUN
Gliding|Планерка|[ˈglaɪdɪŋ]|B2|NOUN
Record|Запись;Досье;Рекорд|[ˈrɛkɔːd]|B2|NOUN
Measurability|Исчислимость;Измеримость;Измерение|[ˌmɛʒərəˈbɪlɪti]|B2|NOUN
Homeschooler|Ученик на домашнем обучении|[həʊm skuːlə]|B2|NOUN
Worksheet|Рабочий лист;Таблица|[ˈwɜːkˌʃiːt]|B2|NOUN
Galore|Множество;Куча;Обилиие|[gəˈlɔː]|B2|NOUN
Prompt|Подсказка;Совет|[prɒmpt]|B2|NOUN
Membership|Членство;Участие;Принадлежность;Состав|[ˈmɛmbəʃɪp]|B2|NOUN
Progress Tracker|Трекер прогресса|[ˈprəʊgrəs ˈtrækə]|B2|NOUN
Sequence|Последовательность;Порядок;Очередь|[ˈsiːkwəns]|B2|NOUN
Undergraduate|Бакалавр;Ученик|[ˌʌndəˈgrædjʊɪt]|B2|NOUN
Degree|Степень;Диплом|[dɪˈgriː]|B2|NOUN
Carer|Воспитатель;Опекун|[ˈkeərə]|B2|NOUN
Transition|Переход;Превращение|[trænˈzɪʃ(ə)n]|B2|NOUN
Recognition|Признание;Осознание|[ˌrɛkəgˈnɪʃən]|B2|NOUN
Workforce|Рабочая сила;Кадры|[wɜːkˌfɔːs]|B2|NOUN
Volunteering|Волонтерство|[ˌvɒlənˈtɪərɪŋ]|B2|NOUN
Internship|Стажировка;Интернатура|[ˈɪntɜːnʃɪp]|B2|NOUN
Accommodation|Проживание;Размещение;Жилье|[əˌkɒməˈdeɪʃ(ə)n]|B2|NOUN
Enrolment|Зачисление;Набор;Поступление|[əˌkɒməˈdeɪʃ(ə)n]|B2|NOUN
Guideline|Рекомендация;Инструкция|[ˈgaɪdlaɪn]|B2|NOUN
Hub|Центр;Средоточие;Концентратор|[hʌb]|B2|NOUN
Piety|Благочестие|[ˈpaɪəti]|B2|NOUN
Impact|Последствие;Результат;Влияние|[ˈɪmpækt]|B2|NOUN
Well-being|Благополучие|[wɛl-ˈbiːɪŋ]|B2|NOUN
Reasoning|Довод;Логика;Обоснование|[ˈriːznɪŋ]|B2|NOUN
Incursion|Нарушение;Столкновение|[ɪnˈkɜːʃən]|B2|NOUN
Venue|Место проведения|[ˈvɛnjuː]|B2|NOUN
Doorstep|Порог квартиры|[ˈdɔːstɛp]|B2|NOUN
Supervisor|Супервайзер|[ˈsjuːpəvaɪzə]|B2|NOUN
Affirmation|Утверждение;Подтверждение|[ˌæfɜːˈmeɪʃ(ə)n]|B2|NOUN
Uptick|Стимул;Увеличение;Толчок;Подъем|[ʌp tɪk]|B2|NOUN
Drop-off|Спад;Снижение;Упадок|[drɒp-ɒf]|B2|NOUN
Conversation|Разговор;Беседа;Обсуждение|[kɒnvəˈseɪʃən]|B2|NOUN
Indifference|Безразличие;Безучастие|[ɪnˈdɪfrəns]|B2|NOUN
Ageism|Эйджизм|[ˈeɪʤɪz(ə)m]|B2|NOUN
Segmentation|Сегментация|[sɛgmɛnˈteɪʃən]|B2|NOUN
Landmark|Веха;Ориентир;Достопримечательность|[ˈlændmɑːk]|B2|NOUN
Upheaval|Переворот;Катастрофа;Волнение|[ʌpˈhiːvəl]|B2|NOUN
Harassment|Преследование;Домогательство|[ˈhærəsmənt]|B2|NOUN
Disarray|Беспорядок;Разброд|[dɪsəˈreɪ]|B2|NOUN
Proof|Доказательство|[pruːf]|B2|NOUN
Influx|Наплыв;Приток|[ˈɪnflʌks]|B2|NOUN
Struggle|Борьба;Поединок;Спор|[ˈstrʌgl]|B2|NOUN
Loneliness|Одиночество;Уединение|[ˈləʊnlɪnəs]|B2|NOUN
Mental Health|Психическое здоровье|[ˈmɛntl hɛlθ]|B2|NOUN
Authenticity|Подлинность;Самобытность|[ˌɔːθɛnˈtɪsɪti]|B2|NOUN
Donation|Пожертвование;Донорство|[dəʊˈneɪʃən]|B2|NOUN
Backlash|Обратная реакция|[ˈbæklæʃ]|B2|NOUN
Connotation|Подтекст;Смысл;Намек|[kɒnəʊˈteɪʃən]|B2|NOUN
Affinity|Близость;Сходство;Симпатия|[ əˈfɪnɪti]|B2|NOUN
Diversification|Диверсификация;Разнообразие|[daɪˌvɜːsɪfɪˈkeɪʃən]|B2|NOUN
Takeover|Поглощение|[pteɪkˌəʊvə]|B2|NOUN
Feminism|Феминизм|[ˈfɛmɪnɪzm]|B2|NOUN
Equality|Равенство|[i(ː)ˈkwɒlɪti]|B2|NOUN
Sustainability|Устойчивость;Стабильность|[səsˌteɪnəˈbɪlɪti]|B2|NOUN
Chunk|Кусок;Ломоть;Глыба|[ʧʌŋk]|B2|NOUN
Repercussion|Последствия;Отзвук|[ˌriːpɜːˈkʌʃən]|B2|NOUN
Preference|Предпочтение;Преимущество|[ˈprɛfərəns]|B2|NOUN
Aspiration|Стремление;Желание|[ˌæspəˈreɪʃ(ə)n]|B2|NOUN
Consumption|Потребление;Расход|[kənˈsʌm(p)ʃən]|B2|NOUN
Mismanagement|Бесхозяйственность|[ˌmɪsˈmænɪʤmənt]|B2|NOUN
Keynote|Лейтмотив|[ˈkiːnəʊt]|B2|NOUN
Rivalry|Соперничество;Противостояние|[ˈraɪvəlri]|B2|NOUN
Disparity|Несоответствие;Неравенство|[dɪsˈpærɪti]|B2|NOUN
Repayment|Расплата;Погашение;Возврат|[riːˈpeɪmənt]|B2|NOUN
Allegation|Обвинение;Утверждение|[ˌælɪˈgeɪʃ(ə)n]|B2|NOUN
Prevalence|Распространенность;Преобладание|[ˈprɛvələns]|B2|NOUN
Nostalgia|Ностальгия;Сожаление|[nɒstˈælʤɪə]|B2|NOUN
Uplighting|Освещение;Просвещение|[ʌp ˈlaɪtɪŋ]|B2|NOUN
Escapism|Эскапизм;Уход;Бегство|[ɪsˈkeɪpɪzm]|B2|NOUN
Nonfiction|Нон-фикшн;Нехудожественная литература|[nɒnˈfɪkʃən]|B2|NOUN
Psychology|Психология|[saɪˈkɒləʤi]|B2|NOUN
Funnel|Воронка;Водоворот|[ˈfʌnl]|B2|NOUN
Amateur|Любитель;Фанат|[ˈæmətə(ː)]|B2|NOUN
Protagonist|Протагонист;Главный герой|[prəʊˈtægənɪst]|B2|NOUN
Pinpoint|Точка опоры;Привязка|[ˈpɪnpɔɪnt]|B2|NOUN
Announcement|Анонс;Объявление|[əˈnaʊnsmənt]|B2|NOUN
Consequence|Заключение;Следствие|[ˈkɒnsɪkwəns]|B2|NOUN
Exaggeration|Преувеличение;Утрирование|[ɪgˌzæʤəˈreɪʃən]|B2|NOUN
Scrutiny|Исследование;Тщательная проверка|[ˈskruːtɪni]|B2|NOUN
Blueprint|План;Проект;Чертеж|[ˈbluːprɪnt]|B2|NOUN
Expansion|Развитие;Расширение|[ɪksˈpænʃən]|B2|NOUN
Extent|Степень;Размах;Масштаб|[ɪksˈtɛnt]|B2|NOUN
Victim|Жертва|[ˈvɪktɪm]|B2|NOUN
Ownership|Право собственности;Владение|[ˈəʊnəʃɪp]|B2|NOUN
Mass-market|Масс-маркет;Массовая торговля|[mæs-ˈmɑːkɪt]|B2|NOUN
Variety|Многообразие;Разновидность|[vəˈraɪəti]|B2|NOUN
Headline|Заголовок;Заглавие|[ˈhɛdlaɪn]|B2|NOUN
Allegation|Утверждение;Заявление;Обвинение|[ˌælɪˈgeɪʃ(ə)n]|B2|NOUN
Restriction|Ограничение;Запрет|[rɪsˈtrɪkʃən]|B2|NOUN
Comprehension|Понимание;Осмысление|[ˌkɒmprɪˈhɛnʃən]|B2|NOUN
Existence|Бытие;Существование|[ɪgˈzɪstəns]|B2|NOUN
Counterpart|Аналог;Двойник|[ˈkaʊntəpɑːt]|B2|NOUN
Goldmine|Золотая жила|[ˈgəʊldmaɪn]|B2|NOUN
Applause|Аплодисменты|[əˈplɔːz]|B2|NOUN
Satisfaction|Удовлетворение;Удовольствие|[ˌsætɪsˈfækʃən]|B2|NOUN
Testimonial|Отзыв|[ˌtɛstəˈməʊniəl]|B2|NOUN
Empathy|Эмпатия|[ˈɛmpəθi]|B2|NOUN
Consideration|Размышление;Соображение|[kənˌsɪdəˈreɪʃən]|B2|NOUN
Touchpoint|Точка соприкосновения|[tʌʧ pɔɪnt]|B2|NOUN
Jargon|Жаргон|[ˈʤɑːgən]|B2|NOUN
Background|Предыстория|[ˈbækgraʊnd]|B2|NOUN
Relief|Помощь;Разрядка|[rɪˈliːf]|B2|NOUN
Perception|Восприятие|[pəˈsɛpʃən]|B2|NOUN
Stance|Позиция;Отношение|[stɑːns]|B2|NOUN
Catharsis|Катарсис|[kəˈθɑːsɪs]|B2|NOUN
Solace|Утешение|[ˈsɒləs]|B2|NOUN
Fast-changing|Быстро меняющийся|[fɑːst-ˈʧeɪnʤɪŋ]|B2|ADJECTIVE
Highly skilled|Высококвалифицированный|[ˈhaɪli skɪld]|B2|ADJECTIVE
Eligible|Подходящий|[ˈɛlɪʤəbl]|B2|ADJECTIVE
Vibrant|Жизнеспособный;Яркий;Живой|[ˈvaɪbrənt]|B2|ADJECTIVE
Lifelong|Пожизненный|[ˈlaɪflɒŋ]|B2|ADJECTIVE
Fully furnished|Полностью обустроенный|[ˈfʊli ˈfɜːnɪʃt]|B2|ADJECTIVE
Canonical|Канонический|[kəˈnɒnɪkəl]|B2|ADJECTIVE
Research-based|Основанный на исследованиях|[rɪˈsɜːʧ-beɪst]|B2|ADJECTIVE
Inspirational|Вдохновляющий|[ˌɪnspəˈreɪʃən(ə)l]|B2|ADJECTIVE
Holistic|Целостный|[həˈlɪstɪk]|B2|ADJECTIVE
Empirical|Эмпирический|[ɛmˈpɪrɪkəl]|B2|ADJECTIVE
Fun-filled|Наполненный весельем|[fʌn-fɪld]|B2|ADJECTIVE
Award-winning|Отмеченный наградой;Награжденный|[əˈwɔːd-ˈwɪnɪŋ]|B2|ADJECTIVE
Rapid|Быстрый|[ˈræpɪd]|B2|ADJECTIVE
Job-ready|Готовый к работе|[ʤɒb-ˈrɛdi]|B2|ADJECTIVE
Median|Средний;Медианный|[ˈmiːdiən]|B2|ADJECTIVE
Lucrative|Выгодный|[ˈluːkrətɪv]|B2|ADJECTIVE
Savvy|Проницательный|[ˈsævi]|B2|ADJECTIVE
Thoughtful|Вдумчивый|[θɔːtfʊl]|B2|ADJECTIVE
Elusive|Неуловимый|[ɪˈluːsɪv]|B2|ADJECTIVE
On-demand|Востребованный|[ɒn-dɪˈmɑːnd]|B2|ADJECTIVE
Nonexistent|Несуществующий|[nɒn ɪgˈzɪstənt]|B2|ADJECTIVE
Luxurious|Роскошный|[lʌgˈzjʊərɪəs]|B2|ADJECTIVE
Entertaining|Развлекательный|[ˌɛntəˈteɪnɪŋ]|B2|ADJECTIVE
Conscious|Сознательный|[ˈkɒnʃəs]|B2|ADJECTIVE
Mythological|Мифологический|[ˌmɪθəˈlɒʤɪkəl]|B2|ADJECTIVE
Prosaic|Прозаический|[prəʊˈzeɪɪk]|B2|ADJECTIVE
Uplifting|Поднимающий настроение|[ʌpˈlɪftɪŋ]|B2|ADJECTIVE
Looming|Надвигающийся|[ˈluːmɪŋ]|B2|ADJECTIVE
People-first|Ориентированный на человека|[ˈpiːpl-fɜːst]|B2|ADJECTIVE
User-generated|Созданный пользователями|[ˈjuːzə-ˈʤɛnəreɪtɪd]|B2|ADJECTIVE
Experimental|Экспериментальный|[ɛksˌpɛrɪˈmɛntl]|B2|ADJECTIVE
Aesthetic|Эстетический|[iːsˈθɛtɪk]|B2|ADJECTIVE
Feasible|Осуществимый|[ˈfiːzəbl]|B2|ADJECTIVE
Foreseeable|Предвидимый|[fɔːˈsiːəbl]|B2|ADJECTIVE
Streamlined|Оптимизированный;Удобный;Обтекаемый|[ˈstriːmlaɪnd]|B2|ADJECTIVE
Brand new|Инновационный|[brænd njuː]|B2|ADJECTIVE
Ephemeral|Эфемерный|[ɪˈfɛmərəl]|B2|ADJECTIVE
Prevalent|Распространенный|[ˈprɛvələnt]|B2|ADJECTIVE
Sizable|Большой|[ˈsaɪzəbl]|B2|ADJECTIVE
Shoppable|Доступный для покупки|[ˈʃɒpəbl]|B2|ADJECTIVE
Stratospheric|Стратосферный|[Strato ˈsfɛrɪk]|B2|ADJECTIVE
Major|Крупный;Главный|[ˈmeɪʤə]|B2|ADJECTIVE
Unprecedented|Беспрецедентный|[ʌnˈprɛsɪdəntɪd]|B2|ADJECTIVE
Exorbitant|Непомерный|[ɪgˈzɔːbɪtənt]|B2|ADJECTIVE
Artistic|Художественный;Творческий|[ɑːˈtɪstɪk]|B2|ADJECTIVE
Prospective|Перспективный|[prəsˈpɛktɪv]|B2|ADJECTIVE
Like-minded|Похожий|[ˈlaɪkˈmaɪndɪd]|B2|ADJECTIVE
Customer-centric|Ориентированный на клиента|[ˈkʌstəmə-ˈsɛntrɪk]|B2|ADJECTIVE
Editorial|Редакционный;Редакторский|[ˌɛdɪˈtɔːrɪəl]|B2|ADJECTIVE
Solitary|Одиночный;Уединенный|[ˈsɒlɪtəri]|B2|ADJECTIVE
Controversial|Спорный|[ˌkɒntrəˈvɜːʃəl]|B2|ADJECTIVE
Shareable|Делимый;Разделяемый|[ˈʃeərəbl]|B2|ADJECTIVE
Journalistic|Журналистский|[ˌʤɜːnəˈlɪstɪk]|B2|ADJECTIVE
Elegiac|Элегический|[ˌɛlɪˈʤaɪək]|B2|ADJECTIVE
Short-lived|Недолговечный|[ʃɔːt-lɪvd]|B2|ADJECTIVE
Authoritative|Авторитетный|[ɔːˈθɒrɪtətɪv]|B2|ADJECTIVE
Subsequent|Последующий|[ˈsʌbsɪkwənt]|B2|ADJECTIVE
Unavoidable|Неизбежный|[ˌʌnəˈvɔɪdəbl]|B2|ADJECTIVE
Disastrous|Катастрофический|[dɪˈzɑːstrəs]|B2|ADJECTIVE
Collaboratively|Совместно|[kəˈlæb(ə)rətɪvli]|B2|ADVERB
Twofold|Вдвойне|[ˈtuːfəʊld]|B2|ADVERB
Backwards|Наоборот;Назад|[ˈbækwədz]|B2|ADVERB
Alongside|Наряду|[əˈlɒŋˈsaɪd]|B2|ADVERB
Face-to-face|Лицом к лицу|[feɪs-tuː-feɪs]|B2|ADVERB
Increasingly|Все чаще|[ɪnˈkriːsɪŋli]|B2|ADVERB
Likewise|Аналогично|[ˈlaɪkwaɪz]|B2|ADVERB
Inherently|По своей сути|[ɪnˈhɪərəntli]|B2|ADVERB
Yearslong|В течение года|[jɪəzlɒŋ]|B2|ADVERB
Dramatically|Значительно|[drəˈmætɪk(ə)li]|B2|ADVERB
Overall|В целом|[ˈəʊvərɔːl]|B2|ADVERB
Sustainably|Устойчиво|[səsˈteɪnˈeɪbli]|B2|ADVERB
Thoroughly|Тщательно|[ˈθʌrəli]|B2|ADVERB
Radically|Радикально|[ˈrædɪkəli]|B2|ADVERB
Undeniably|Бесспорно|[ˌʌndɪˈnaɪəbli]|B2|ADVERB
Amongst|Среди|[əˈmʌŋst]|B2|ADVERB
Specifically|Конкретно|[spəˈsɪfɪk(ə)li]|B2|ADVERB
Unless|Если только|[ənˈlɛs]|B2|ADVERB
Seamless|Беспрепятственно|[ˈsiːmlɪs]|B2|ADVERB
Alternatively|Альтернативно|[ɔːlˈtɜːnətɪvli]|B2|ADVERB
Disproportionately|Непропорционально|[ˌdɪsprəˈpɔːʃnɪtli]|B2|ADVERB
Innermost|Сокровенно|[ˈɪnəməʊst]|B2|ADVERB
Midway|Посредине|[ˈmɪdˈweɪ]|B2|ADVERB
Unthinkable|Немыслимо|[ʌnˈθɪŋkəbl]|B2|ADVERB
Ruthlessly|Беспощадно|[ˈruːθlɪsli]|B2|ADVERB
Altogether|В целом|[ˌɔːltəˈgɛðə]|B2|ADVERB
Beneath|Под, внизу|[bɪˈniːθ]|B2|ADVERB
Factually|По-настоящему|[ˈfækʧʊəli]|B2|ADVERB
Indeed|Действительно|[ɪnˈdiːd]|B2|ADVERB
Occasionally|Время от времени|[əˈkeɪʒnəli]|B2|ADVERB
Plenty|Много;Достаточно;Полно|[ˈplɛnti]|B2|ADVERB
Anywise|Как угодно|[ˈɛnɪwaɪz]|B2|ADVERB
Somewhere|Где-то|[ˈsʌmweə]|B2|ADVERB
Throughout|Повсюду|[θruːˈaʊt]|B2|ADVERB
Scarcely|Скудно;Редко|[ˈskeəsli]|B2|ADVERB
Weekly|Еженедельно|[ˈwiːkli]|B2|ADVERB
Quietly|Тихо|[ˈkwaɪətli]|B2|ADVERB
Rather too|Скорее слишком|[ˈrɑːðə tuː]|B2|ADVERB
Chiefly|В основном|[ˈʧiːfli]|B2|ADVERB
To abate|Сокращать;Уменьшать;Ослаблять|[əˈbeɪt]|C1|VERB
To abjure|Отказаться;Отрекаться;Воздерживаться|[əbˈʤʊə]|C1|VERB
To dangle|Болтаться;Зависать;Висеть|[ˈdæŋgl]|C1|VERB
To abscond|Скрыться;Пропасть;Уйти|[əbˈskɒnd]|C1|VERB
To assuage|Успокаивать;Утешать;Усмирять|[əˈsweɪʤ]|C1|VERB
To disabuse|Разочаровать;Расстроить;Развенчать|[ˌdɪsəˈbjuːz]|C1|VERB
To equivocate|Увиливать;Оправдываться;Оспаривать|[ɪˈkwɪvəkeɪt]|C1|VERB
To incise|Надрезать|[ɪnˈsaɪz]|C1|VERB
To diminish|Уменьшать|[dɪˈmɪnɪʃ]|C1|VERB
To jeopardize|Ставить под угрозу|[ˈʤɛpədaɪz]|C1|VERB
To breed|Размножаться|[briːd]|C1|VERB
To prevaricate|Преувеличивать|[prɪˈværɪkeɪt]|C1|VERB
To recant|Отказаться от показаний|[rɪˈkænt]|C1|VERB
To refute|Опровергать|[rɪˈfjuːt]|C1|VERB
To ignoble|Обольстить|[ɪgˈnəʊbl]|C1|VERB
To banish|Изгнать|[ˈbænɪʃ]|C1|VERB
To disavow|Отречься|[ˌdɪsəˈvaʊ]|C1|VERB
To explode|Взорваться|[ɪksˈpləʊd]|C1|VERB
To unearth|Раскопать|[ʌnˈɜːθ]|C1|VERB
To depict|Отобразить|[dɪˈpɪkt]|C1|VERB
To unpick|Распарывать;Распустить|[ʌnˈpɪk]|C1|VERB
To originate|Зарождаться|[əˈrɪʤɪneɪt]|C1|VERB
To pluck|Вырывать|[plʌk]|C1|VERB
To amass|Накапливать|[əˈmæs]|C1|VERB
To staff|Укомплектовать|[stɑːf]|C1|VERB
To shrink|Сокращаться|[ʃrɪŋk]|C1|VERB
To mold|Лепить|[məʊld]|C1|VERB
To contrive|Придумывать|[kənˈtraɪv]|C1|VERB
To entice|Завлекать|[ɪnˈtaɪs]|C1|VERB
To pervade|Пронизывать|[pɜːˈveɪd]|C1|VERB
To prevail|Преобладать|[prɪˈveɪl]|C1|VERB
To supersede|Вытеснять|[ˌsjuːpəˈsiːd]|C1|VERB
To redeem|Выкупить|[rɪˈdiːm]|C1|VERB
To wrack|Потревожить|[ræk]|C1|VERB
To mesh|Зацеплять|[mɛʃ]|C1|VERB
To render|Оказывать|[ˈrɛndə]|C1|VERB
To lease|Сдать в аренду|[liːs]|C1|VERB
To stipulate|Оговаривать|[ˈstɪpjʊleɪt]|C1|VERB
To decree|Постановить|[dɪˈkriː]|C1|VERB
To reminisce|Вспоминать|[ˌrɛmɪˈnɪs]|C1|VERB
To rarefy|Редеть|[ˈreərɪfaɪ]|C1|VERB
To venerate|Почитать|[ˈvɛnəreɪt]|C1|VERB
To hatch|Вылупляться|[hæʧ]|C1|VERB
To anchor|Бросить якорь|[ˈæŋkə]|C1|VERB
To inherit|Получить в наследство|[ɪnˈhɛrɪt]|C1|VERB
To stab|Закалывать;Нападать;Вонзать|[stæb]|C1|VERB
To sublet|Сдавать в субаренду|[ˌsʌbˈlɛt]|C1|VERB
To outline|Начертить;Обрисовать;Наметить|[ˈaʊtlaɪn]|C1|VERB
To infiltrate|Проникнуть;Внедриться;Просачиваться|[ˈɪnfɪltreɪt]|C1|VERB
To utter|Произносить;Изрекать;Проговаривать|[ˈʌtə]|C1|VERB
To vituperate|Издеваться;Обижать|[vɪˈtjuːpəreɪt]|C1|VERB
To waver|Колебаться;Извиваться;Дрогнуть|[ˈweɪvə]|C1|VERB
To withstand|Выдерживать;Устоять;Терпеть|[wɪðˈstænd]|C1|VERB
To swap|Поменять местами;Сменить|[swɒp]|C1|VERB
To coax|Соединить|[kəʊks]|C1|VERB
To conspire|Сговориться|[kənˈspaɪə]|C1|VERB
To append|Приложить|[əˈpɛnd]|C1|VERB
To entail|Влечь за собой|[ɪnˈteɪl]|C1|VERB
To repine|Порицать|[rɪˈpaɪn]|C1|VERB
To glance|Бросить взгляд;Мельком глянуть|[glɑːns]|C1|VERB
To resort|Прибегать|[rɪˈzɔːt]|C1|VERB
To substitute|Заменить|[ˈsʌbstɪtjuːt]|C1|VERB
To surpass|Превзойти|[sɜːˈpɑːs]|C1|VERB
To deem|Считать|[diːm]|C1|VERB
To prophesy|Пророчествовать|[ˈprɒfɪsaɪ]|C1|VERB
To alienate|Отчуждать|[ˈeɪliəneɪt]|C1|VERB
To reimburse|Возмещать|[ˌriːɪmˈbɜːs]|C1|VERB
To disperse|Рассеивать;Расходиться|[dɪsˈpɜːs]|C1|VERB
To overlook|Упускать из виду|[ˌəʊvəˈlʊk]|C1|VERB
To dismantle|Демонтировать;Разобрать;Убрать;Разрушить|[dɪsˈmæntl]|C1|VERB
To exhilarate|Взбодриться|[ɪgˈzɪləreɪt]|C1|VERB
To thrill|Возбуждать|[θrɪl]|C1|VERB
To underpin|Поддерживать|[ˌʌndəˈpɪn]|C1|VERB
To follow-up|Следить|[ˈfɒləʊˈʌp]|C1|VERB
To predispose|Предрасполагать;Склонять;Располагать|[ˌpriːdɪsˈpəʊz]|C1|VERB
To peer|Равняться;Сравнивать;Подглядывать|[pɪə]|C1|VERB
To intervene|Вмешиваться|[ˌɪntə(ː)ˈviːn]|C1|VERB
To resonate|Резонировать|[ˈrɛzəˌneɪt]|C1|VERB
To contradict|Противоречить;Возражать;Опровергнуть|[ˌkɒntrəˈdɪkt]|C1|VERB
To distil|Дистиллировать;Смягчать;Рассеивать|[dɪsˈtɪl]|C1|VERB
To mitigate|Смягчать;Сгладить;Ослабить|[ˈmɪtɪgeɪt]|C1|VERB
To bounce back|Отскочить;Вернуться;Возвращаться;Восстановиться|[baʊns bæk]|C1|VERB
To indulge|Побаловать;Потакать;Потворствовать|[ɪnˈdʌlʤ]|C1|VERB
To sniff|Нюхать;Принюхиваться;Сопеть|[snɪf]|C1|VERB
To unveil|Раскрыть|[ʌnˈveɪl]|C1|VERB
To discard|Отказаться;Списывать;Отвергнуть|[ˈdɪskɑːd]|C1|VERB
To eradicate|Искоренить|[ɪˈrædɪkeɪt]|C1|VERB
To propagate|Распространять|[ˈprɒpəgeɪt]|C1|VERB
To terminate|Прекратить|[ˈtɜːmɪneɪt]|C1|VERB
To engross|Захватить|[ɪnˈgrəʊs]|C1|VERB
To overtake|Обгонять;Нагнать;Преодолеть|[əʊvəˈteɪk]|C1|VERB
To shield|Укрыть;Заслонить;Оградить|[ʃiːld]|C1|VERB
To ingest|Проглотить|[ɪnˈʤɛst]|C1|VERB
To malign|Очернить|[məˈlaɪn]|C1|VERB
To exhibit|Выставлять|[ɪgˈzɪbɪt]|C1|VERB
To extirpate|Уничтожить|[ˈɛkstɜːpeɪt]|C1|VERB
To initiate|Инициировать|[ɪˈnɪʃɪɪt]|C1|VERB
To adjoy|Придерживаться|[ædʤɔɪ]|C1|VERB
To delve|Углубиться|[dɛlv]|C1|VERB
To vow|Клясться;Ручаться;Обещать|[vaʊ]|C1|VERB
Axis|Ось|[ˈæksɪs]|C1|NOUN
Modality|Метод;Форма|[məʊˈdælɪti]|C1|NOUN
Discerning|Распознавание|[dɪˈsɜːnɪŋ]|C1|NOUN
Similarity|Сходство;Подобие;Аналогия|[sɪmɪˈlærɪti]|C1|NOUN
Pattern|Образец;Модель;Схема|[pætən]|C1|NOUN
Sequencing|Последовательность;Порядок;Упорядочивание|[ˈsiːkwənsɪŋ]|C1|NOUN
Anthropologist|Антрополог|[ˌænθrəˈpɒləʤɪst]|C1|NOUN
Oversight|Надзор;Контроль|[ˈəʊvəsaɪt]|C1|NOUN
Exhibition|Выставка|[ˌɛksɪˈbɪʃən]|C1|NOUN
Specimen|Образец;Модель;Экспонат|[ˈspɛsɪmɪn]|C1|NOUN
Interference|Интерференция;Вмешательство|[ˌɪntəˈfɪərəns]|C1|NOUN
Bureaucracy|Бюрократия|[bjʊəˈrɒkrəsi]|C1|NOUN
Generation|Поколение|[ˌʤɛnəˈreɪʃən]|C1|NOUN
Evolutionist|Эволюционист|[ˌiːvəˈluːʃənɪst]|C1|NOUN
Significance|Значение;Значимость;Важность|[sɪgˈnɪfɪkəns]|C1|NOUN
Unveiling|Разоблачение;Раскрытие|[ʌnˈveɪlɪŋ]|C1|NOUN
Implication|Следствие;Последствие;Подтекст;Влияние|[ˌɪmplɪˈkeɪʃən]|C1|NOUN
Biomarker|Биомаркер|[ˈbaɪəʊˈmɑːkə]|C1|NOUN
Offspring|Потомство|[ˈɒfsprɪŋ]|C1|NOUN
Cognition|Познание|[kɒgˈnɪʃən]|C1|NOUN
Prevalence|Распространенность;Превалирование;Предрасположенность|[kɒgˈnɪʃən]|C1|NOUN
Conjecture|Догадка;Гипотеза|[kənˈʤɛkʧə]|C1|NOUN
Percentage|Процент;Процентовка|[pəˈsɛntɪʤ]|C1|NOUN
Existence|Существование;Наличие|[ɪgˈzɪstəns]|C1|NOUN
Assertion|Утверждение;Заявление|[əˈsɜːʃ(ə)n]|C1|NOUN
Correlation|Соотношение;Корреляция;Взаимосвязь|[ˌkɒrɪˈleɪʃən]|C1|NOUN
Cohort|Когорта;Выборка;Совокупность|[ˈkəʊhɔːt]|C1|NOUN
Extent|Протяженность;Объем;Степень|[ɪksˈtɛnt]|C1|NOUN
Coherence|Когерентность;Слаженность;Связь|[kəʊˈhɪərəns]|C1|NOUN
Abstractedness|Абстрактность|[æbˈstræktɪdnɪs]|C1|NOUN
Gist|Суть;Сущность;Понятие;Смысл|[ʤɪst]|C1|NOUN
Likelihood|Вероятность;Правдоподобность;Достоверность|[ˈlaɪklɪhʊd]|C1|NOUN
Instance|Экземпляр;Объект;Вариант|[ˈɪnstəns]|C1|NOUN
Vindication|Доказательство|[ˌvɪndɪˈkeɪʃən]|C1|NOUN
Ambiguity|Двусмысленность;Неоднозначность|[ˌæmbɪˈgju(ː)ɪti]|C1|NOUN
Perseverance|Настойчивость;Упорство|[ˌpɜːsɪˈvɪərəns]|C1|NOUN
Disobedience|Непослушание;Непокорность|[ˌdɪsəˈbiːdjəns]|C1|NOUN
Adolescent|Подросток|[ˌædəʊˈlɛsnt]|C1|NOUN
Neuroticism|Невротизм|[njʊəˈrɒtɪkɪz(ə)m]|C1|NOUN
Attempt|Попытка;Испытание|[əˈtɛmpt]|C1|NOUN
Willingness|Готовность;Желание;Воля;Стремление|[ˈwɪlɪŋnɪs]|C1|NOUN
Impulsivity|Импульсивность;Порыв;Побуждение|[ɪmˌpʌlˈsɪvətɪ]|C1|NOUN
Proponent|Сторонник|[prəˈpəʊnənt]|C1|NOUN
Irritability|Раздражительность;Вспыльчивость|[ˌɪrɪtəˈbɪlɪti]|C1|NOUN
Prison conviction|Тюремное заключение;Приговор|[ˈprɪzn kənˈvɪkʃən]|C1|NOUN
Anxiety|Беспокойство;Тревога;Раздражительность|[æŋˈzaɪəti]|C1|NOUN
Restlessness|Сдержанность;Невозмутимость|[ˈrɛstlɪsnɪs]|C1|NOUN
Disparity|Неравенство;Несоответствие|[dɪsˈpærɪti]|C1|NOUN
Procrastination|Прокрастинация|[prəʊˌkræstɪˈneɪʃən]|C1|NOUN
Downward|Снижение;Уныние|[ˈdaʊnwəd]|C1|NOUN
Self-restraint|Самоограничение;Самоконтроль|[sɛlf-rɪsˈtreɪnt]|C1|NOUN
Temptation|Искушение;Соблазн|[tɛmpˈteɪʃən]|C1|NOUN
Boundary-setting|Установление границ|[ˈbaʊndəri-ˈsɛtɪŋ]|C1|NOUN
Distraction|Отвлечение;Рассеянность|[dɪsˈtrækʃən]|C1|NOUN
Compassion|Сострадание;Сочувствие;Жалость|[kəmˈpæʃən]|C1|NOUN
Stigma|Клеймо|[ˈstɪgmə]|C1|NOUN
Affection|Привязанность;Симпатия;Любовь|[əˈfɛkʃ(ə)n]|C1|NOUN
Discrimination|Дискриминация|[dɪsˌkrɪmɪˈneɪʃən]|C1|NOUN
Conscientiousness|Совестливость;Осознанность|[ˌkɒnʃɪˈɛnʃəsnəs]|C1|NOUN
Bias|Предубеждение;Предвзятость|[ˈbaɪəs]|C1|NOUN
Ingenuity|Изобретательность|[ˌɪnʤɪˈnju(ː)ɪti]|C1|NOUN
Upbringing|Воспитание|[ˈʌpˌbrɪŋɪŋ]|C1|NOUN
Deterrent|Сдерживающий фактор|[dɪˈtɛrənt]|C1|NOUN
Multitude|Многочисленность;Разнообразие|[ˈmʌltɪtjuːd]|C1|NOUN
Inheritance|Наследственность|[ɪnˈhɛrɪtəns]|C1|NOUN
Compromise|Компромисс;Примирение|[ˈkɒmprəmaɪz]|C1|NOUN
Untidiness|Неопрятность;Неряшливость|[ʌnˈtaɪdɪnɪs]|C1|NOUN
Footprint|След;Отпечаток;Воздействие|[ˈfʊtprɪnt]|C1|NOUN
Conservationist|Консерватор;Хранитель;Сторонник|[ˌkɒnsə(ː)ˈveɪʃənɪst]|C1|NOUN
Feasibility|Осуществимость;Обоснованность|[ˌkɒnsə(ː)ˈveɪʃənɪst]|C1|NOUN
Earthquake|Землетрясение|[ˈɜːθkweɪk]|C1|NOUN
Stillness|Неподвижность;Штиль;Затишье|[ˈstɪlnəs]|C1|NOUN
Contamination|Загрязнение;Заражение|[kənˌtæmɪˈneɪʃən]|C1|NOUN
Lifespan|Продолжительность жизни|[ˈlaɪfspæn]|C1|NOUN
Wilderness|Дикая природа|[ˈwɪldənɪs]|C1|NOUN
Predator|Хищник|[ˈprɛdətə]|C1|NOUN
Overpopulation|Перенаселение|[ˌəʊvəˌpɒpjʊˈleɪʃən]|C1|NOUN
Aftermath|Последствия|[ˈɑːftəmæθ]|C1|NOUN
Wasteland|Пустошь|[ˈweɪstˌlænd]|C1|NOUN
Grassland|Пастбище|[ˈgrɑːslænd]|C1|NOUN
Cattle|Крупный рогатый скот|[ˈkætl]|C1|NOUN
Carbon emission|Выброс углерода|[ˈkɑːbən ɪˈmɪʃən]|C1|NOUN
Deteriorating|Ухудшение;Деградация|[dɪˈtɪərɪəreɪtɪŋ]|C1|NOUN
Erasure|Стирание|[ɪˈreɪʒə]|C1|NOUN
Drought|Засуха|[draʊt]|C1|NOUN
Dieback|Вымирание|[ˈdaɪˌbæk]|C1|NOUN
Foraging|Кормление|[ˈfɒrɪʤɪŋ]|C1|NOUN
Breeding|Размножение|[ˈbriːdɪŋ]|C1|NOUN
Fluctuation|Колебания;Зыбкость|[ˌflʌktjʊˈeɪʃən]|C1|NOUN
Resilience|Жизнеспособность;Устойчивость|[rɪˈzɪlɪəns]|C1|NOUN
Hedgerow|Живая изгородь|[ˈhɛʤrəʊ]|C1|NOUN
Ditche|Канава;Траншея;Сточная яма|[dɪtʃ]|C1|NOUN
Coastal|Прибрежная зона|[ˈkəʊstəl]|C1|NOUN
Combustion|Сжигание;Горение|[kəmˈbʌsʧən]|C1|NOUN
Restoration|Восстановление|[ˌrɛstəˈreɪʃən]|C1|NOUN
Disturbance|Нарушение;Вмешательство|[dɪsˈtɜːbəns]|C1|NOUN
Encroachment|Вторжение;Захват;Поглощение|[ɪnˈkrəʊʧmənt]|C1|NOUN
Photosynthesis|Фотосинтез|[ˌfəʊtəʊˈsɪnθɪsɪs]|C1|NOUN
Annihilation|Уничтожение;Разрушение;Удаление|[əˌnaɪəˈleɪʃ(ə)n]|C1|NOUN
Overload|Перегрузка|[ˈəʊvələʊd]|C1|NOUN
Biodiversity|Биологическое разнообразие|[ˌbaɪəʊdaɪˈvɜːsɪti]|C1|NOUN
Sustenance|Пропитание;Питание|[ˈsʌstɪnəns]|C1|NOUN
Limestone|Известняк|[ˈlaɪmstəʊn]|C1|NOUN
Sequestration|Секвестрация;Поглощение|[ˌsiːkwɛsˈtreɪʃən]|C1|NOUN
Wilderness|Дикая природа|[ˈwɪldənɪs]|C1|NOUN
Inaccessible|Недоступный|[ˌɪnækˈsɛsəbl]|C1|ADJECTIVE
Pioneering|Новаторский;Первый|[ˌpaɪəˈnɪərɪŋ]|C1|ADJECTIVE
Astonishing|Поразительный|[əsˈtɒnɪʃɪŋ]|C1|ADJECTIVE
Eccentric|Эксцентричный;Экстравагантный|[ɪkˈsɛntrɪk]|C1|ADJECTIVE
Ethnographic|Этнографический|[ˌɛθnəʊˈgræfɪk]|C1|ADJECTIVE
Quintessential|Полный;Оригинальный|[ˌkwɪntɪˈsɛnʃəl]|C1|ADJECTIVE
Colonial|Колониальный|[kəˈləʊniəl]|C1|ADJECTIVE
Religious|Религиозный|[rɪˈlɪʤəs]|C1|ADJECTIVE
Multi-sensory|Мультисенсорный;Чувственный|[ˈmʌltɪ-ˈsɛnsəri]|C1|ADJECTIVE
Life-threatening|Опасный для жизни;Угрожающий|[laɪf-ˈθrɛtnɪŋ]|C1|ADJECTIVE
Subsequent|Последующий;Дальнейший|[ˈsʌbsɪkwənt]|C1|ADJECTIVE
Uneventful|Беспристрастный|[ˌʌnɪˈvɛntfʊl]|C1|ADJECTIVE
Insightful|Проницательный|[ˈɪnsaɪtf(ə)l]|C1|ADJECTIVE
Apparent|Очевидный|[əˈpærənt]|C1|ADJECTIVE
Disrespectful|Неуважительный|[ˌdɪsrɪsˈpɛktfʊl]|C1|ADJECTIVE
Inefficient|Неэффективный|[ˌɪnɪˈfɪʃənt]|C1|ADJECTIVE
Abnormal|Аномальный|[æbˈnɔːməl]|C1|ADJECTIVE
Detectable|Обнаруживаемый;Различимый;Выявляемый|[dɪˈtɛktəbl]|C1|ADJECTIVE
Cellular|Клеточный|[ˈsɛljʊlə]|C1|ADJECTIVE
Counterintuitive|Нелогичный;Противоречивый;Парадоксальный|[kaʊntərɪnˈtjuːɪtɪv]|C1|ADJECTIVE
Disparate|Разрозненный;Несопоставимый|[ˈdɪspərɪt]|C1|ADJECTIVE
Excessive|Чрезмерный;Избыточный|[ɪkˈsɛsɪv]|C1|ADJECTIVE
Detrimental|Пагубный;Губительный;Вредный|[ˌdɛtrɪˈmɛntl]|C1|ADJECTIVE
Indecisive|Нерешительный;Неопределенный;Неясный|[ˌɪndɪˈsaɪsɪv]|C1|ADJECTIVE
Resilient|Устойчивый;Упругий;Эластичный|[rɪˈzɪlɪənt]|C1|ADJECTIVE
Adverse|Неблагоприятный;Негативный|[ˈædvɜːs]|C1|ADJECTIVE
Manageable|Управляемый;Поддающийся;Преодолимый|[ˈmænɪʤəbl]|C1|ADJECTIVE
Ingenious|Изобретательный;Оригинальный|[ɪnˈʤiːniəs]|C1|ADJECTIVE
Free-roaming|Свободный|[friː-ˈrəʊmɪŋ]|C1|ADJECTIVE
Harsh|Суровый;Резкий;Жесткий;Грубый|[hɑːʃ]|C1|ADJECTIVE
Warm-blooded|Теплокровный|[wɔːm-ˈblʌdɪd]|C1|ADJECTIVE
Ground-breaking|Новаторский|[graʊnd-ˈbreɪkɪŋ]|C1|ADJECTIVE
Uninhabitable|Непригодный для жизни|[ˌʌnɪnˈhæbɪtəbl]|C1|ADJECTIVE
Hilarious|Уморительный;Веселый|[hɪˈleərɪəs]|C1|ADJECTIVE
Unconscious|Бессознательный;Неосознанный|[ʌnˈkɒnʃəs]|C1|ADJECTIVE
Reproducible|Воспроизводимый|[ˌriːprəˈdjuːsəbl]|C1|ADJECTIVE
Grim|Мрачный;Грозный|[grɪm]|C1|ADJECTIVE
Irrefutable|Неопровержимый|[ɪˈrɛfjʊtəbl]|C1|ADJECTIVE
Simplistic|Упрощённый;Простой;Простодушный|[sɪmˈplɪstɪk]|C1|ADJECTIVE
Disastrous|Катастрофический|[dɪˈzɑːstrəs]|C1|ADJECTIVE
Scarce|Скудный;Дефицитный|[skeəs]|C1|ADJECTIVE
Vicious|Злобный;Порочный;Ужасный|[ˈvɪʃəs]|C1|ADJECTIVE
Head-to-tail|От начала до конца|[hɛd-tuː-teɪl]|C1|ADVERB
Extensively|Широко;Основательно;Подробно|[ɪksˈtɛnsɪvli]|C1|ADVERB
Mistakenly|Ошибочно|[mɪsˈteɪkənli]|C1|ADVERB
Initially|Первоначально;Изначально|[ɪˈnɪʃəli]|C1|ADVERB
Remarkably|Замечательно;Удивительно|[rɪˈmɑːkəbli]|C1|ADVERB
Broadly|Широко;Обширно;Значительно|[ˈbrɔːdli]|C1|ADVERB
Posthumously|Посмертно;Подспудно|[ˈpɒstjʊməsli]|C1|ADVERB
Respectively|Соответственно;Следовательно|[rɪsˈpɛktɪvli]|C1|ADVERB
Clumsily|Неуклюже;Грубо;Неудачно;Бестолково|[ˈklʌmzɪli]|C1|ADVERB
Deliberately|Сознательно|[dɪˈlɪbərɪtli]|C1|ADVERB
Subconsciously|Подсознательно;Неосознанно|[ˌsʌbˈkɒnʃəsli]|C1|ADVERB
Irrespective|Независимо|[ˌɪrɪsˈpɛktɪv]|C1|ADVERB
Albeit|Хотя;Однако;Несмотря|[ɔːlˈbiːɪt]|C1|ADVERB
Strictly|Строго;Неукоснительно;Жестко|[ˈstrɪktli]|C1|ADVERB
Fiercely|Яростно;Свирепо;Решительно|[ˈfɪəsli]|C1|ADVERB
Arguably|Спорно;Предположительно|[ˈɑːgjʊəbli]|C1|ADVERB
Unremittingly|Неослабно;Решительно, безоговорочно|[ˌʌnrɪˈmɪtɪŋli]|C1|ADVERB
Justifiably|Оправданно|[ˈʤʌstɪfaɪəbli]|C1|ADVERB
Undeniably|Неоспоримо|[ˌʌndɪˈnaɪəbli]|C1|ADVERB
Candidly|Откровенно;Честно;Искренне|[ˈkændɪdli]|C1|ADVERB
Allegedly|Предположительно|[əˈlɛʤdli]|C1|ADVERB
Chronically|Хронически|[ˈkrɒnɪk(ə)li]|C1|ADVERB
Improperly|Неправильно;Неправомерно|[ɪmˈprɒpəli]|C1|ADVERB
Unconsciously|Бессознательно|[ʌnˈkɒnʃəsli]|C1|ADVERB
Worrisomely|Тревожно|[ˈwʌrɪsəmli]|C1|ADVERB
Oftentimes|Нередко;Зачастую;Часто|[ˈɒfntaɪmz]|C1|ADVERB
Self-perpetuatingly|Самостоятельно|[sɛlf-pəˈpɛʧʊeɪtɪŋli]|C1|ADVERB
Radically|В корне;Радикально;Принципиально|[ˈrædɪkəli]|C1|ADVERB
Wrongfully|Несправедливо;Ошибочно|[ˈrɒŋfʊli]|C1|ADVERB
Indisputable|Бесспорно;Неоспоримо|[ˌɪndɪsˈpjuːtəbl]|C1|ADVERB